4444444444444444444444444444444
5111111111111111111111111111115
5111111111111111111111111111115
5111322222222251132222222221115
5111311111111151131111111151115
5111311111111151131111111151115
5111311111111151131111111151115
5111311111111151131111111151115
5111311111111151131111111151115
5111311111111151131111111151115
5111311111111151131111111151115
5111311111111151131111111151115
5111311111111111111111111151115
5111311111111111111111111151115
5111311111111111111111111151115
5111311111111111111111111151115
5111311111111111111111111151115
5111444444444444444444444441115
5111111111111111111111111111115
5111111111111111111111111111115
5111111111111111111111111111115
5444444444444441144444444444445
5000000000000051130000000000000
5000000000000051130000000000000
5000000000000051130000000000000
5000000000000051130000000000000
5000000000000051130000000000000
5000000000000051130000000000000
5000000000000051130000000000000
5000000000000051130000000000000
5000000000000051130000000000000
5000000000000002200000000000000